+--+--+--+--+--+--+--+
|     |              |
+  +--+  +  +  +--+  +
|     |  |  |     |  |
+  +  +  +  +--+  +--+
|  |     |  |     |  |
+--+--+--+  +--+--+  +
|     |           |  |
+  +--+--+  +--+  +  +
|              |     |
+--+--+--+--+--+--+--+
